0	0	0	0	0	0	0	0	0	0	0
0	0	0	0	0	0	0	0	0	0	0
0	-1	0	-1	0	-1	0	-1	0	-1	0
0	7	0	5	0	6	0	6	0	5	0
0	1	0	3	0	7	0	2	0	4	0
0	3	0	2	0	6	0	1	0	2	0
0	4	0	2	0	6	0	5	0	4	0
0	0	-1	0	-1	0	-1	0	-1	0	0
0	0	1	0	3	0	-1	0	-1	0	0
0	0	1	0	3	0	-1	0	-1	0	0
0	0	4	0	5	0	-1	0	-1	0	0
0	0	7	0	7	0	-1	0	-1	0	0
0	0	0	0	0	0	0	0	0	0	0
